###################################
#.................................#
#.................................#
#.................................#
#.................................#
#.......#####################.....#
#.................................#
#.................................#
#.................................#
#.................................#
#.................................#
#.......#####################.....#
#.................................#
#.................................#
#.................................#
#.................................#
#.................................#
#.......#####################.....#
#.................................#
#.................................#
#.................................#
#.................................#
#.................................#
#.................................#
#.......#####################.....#
#.................................#
#.................................#
#.................................#
#.................................#
#.................................#
#.................................#
#.................................#
###################################