###################################
#.................................#
#.................................#
#.................................#
#...###########################...#
#.................................#
#.................................#
#.................................#
#.................................#
#.................................#
#.................................#
#...###########################...#
#.................................#
#.................................#
#...#.........................#...#
#...#.........................#...#
#...#.........................#...#
#...#.........................#...#
#...#.........................#...#
#...#.........................#...#
#...#.....##############......#...#
#...#.........................#...#
#...#.........................#...#
#...#.........................#...#
#...#.........................#...#
#...#.........................#...#
#...###########################...#
#.................................#
#.................................#
#.................................#
#...###########################...#
#.................................#
###################################